{
    "columns": 15,
    "rows": 15,
    "levelmap":
    [
         5,  4,  3,  3,  4,  4,  5,  7,  3,  4,  3,  7,  3,  4,  5,
         4,  1,  1,  1,  1,  1,  1,  1,  1,  1,  1,  1,  1,  1,  3,
         3,  7,  1,  3,  5,  3,  1,  4,  3,  1,  3,  1,  1,  1,  3,
         4,  1,  1,  1,  1,  1,  1,  1,  1,  1,  4,  1,  1,  1,  3,
         5,  4,  3,  7,  1,  7,  4,  3,  1,  5,  3,  7,  4,  1,  7,
         4,  1,  1,  1,  1,  1,  1,  1,  1,  1,  7,  1,  3,  1,  4,
         4,  1,  1,  1,  1,  1,  1,  1,  1,  1,  3,  1,  5,  1,  5,
         3,  1,  1,  1,  1,  1,  1,  1,  1,  1,  4,  1,  4,  1,  3,
         4,  1,  1,  1,  1,  1,  1,  1,  1,  1,  1,  1,  1,  1,  4,
         4,  1,  1,  1,  1,  1,  1,  1,  1,  1,  3,  1,  3,  4,  4,
         7,  1,  1,  1,  1,  1,  1,  1,  1,  1,  4,  1,  1,  1,  4,
         3,  1,  1,  1,  1,  1,  1,  1,  1,  1,  5,  1,  3,  1,  7,
         3,  1,  1,  1,  1,  1,  1,  1,  1,  1,  7,  1,  5,  1,  4,
         4,  1,  1,  1,  1,  1,  1,  1,  1,  1,  1,  1,  4,  1,  8,
         5,  4,  3,  7,  3,  3,  4,  5,  4,  4,  3,  3,  3,  4,  5
    ],
    "player":
    {
        "X": 1,
        "Y": 1,
        "tile": 0
    },
    "treasure":
    [
        {
            "X": 11,
            "Y": 5,
            "tile": 3,
            "points": 1000
        }
    ],
    "food":
    [
        {
            "X": 13,
            "Y": 1,
            "tile": 4,
            "energy": 50
        }
    ],
    "monster":
    [
        {
            "X": 11,
            "Y": 6,
            "tile": 6,
            "damage": 10,
            "type": "SN"
        },
        {
            "X": 1,
            "Y": 3,
            "tile": 6,
            "damage": 10,
            "type": "EW"
        }
    ],
    "exit":
    [
        {
            "startX": 14,
            "startY": 13,
            "tile": -1,
            "destination": "level01"
        }
    ]
}