{
    "columns": 15,
    "rows": 15,
    "levelmap":
    [
         5,  4,  3,  3,  4,  4,  5,  7,  3,  4,  3,  7,  3,  4,  5,
         4,  1,  1,  1,  1,  1,  1,  1,  1,  1,  1,  1,  1,  1,  3,
         3,  1,  7,  1,  1,  1,  1,  1,  1,  1,  3,  1,  1,  1,  3,
         4,  1,  1,  1,  1,  1,  1,  1,  1,  1,  4,  7,  1,  1,  3,
         5,  1,  1,  1,  1,  1,  1,  1,  1,  1,  3,  1,  4,  1,  7,
         4,  1,  1,  1,  1,  1,  1,  1,  1,  1,  7,  1,  3,  1,  4,
         4,  1,  1,  1,  1,  1,  1,  1,  1,  1,  3,  1,  5,  1,  5,
         3,  1,  1,  1,  1,  1,  1,  1,  1,  1,  4,  1,  4,  1,  3,
         4,  1,  1,  1,  1,  1,  1,  1,  1,  1,  5,  1,  1,  1,  4,
         4,  1,  1,  1,  1,  1,  1,  1,  1,  1,  3,  1,  3,  4,  4,
         7,  1,  1,  1,  1,  1,  1,  1,  1,  1,  4,  1,  1,  1,  4,
         3,  1,  1,  1,  1,  1,  1,  1,  1,  1,  5,  1,  3,  1,  7,
         3,  1,  1,  1,  1,  1,  1,  1,  1,  1,  7,  1,  5,  1,  4,
         4,  1,  1,  1,  1,  1,  1,  1,  1,  1,  1,  1,  4,  1,  1,
         5,  4,  3,  7,  3,  3,  4,  5,  4,  4,  3,  3,  3,  4,  5
    ],
    "player":
    {
        "startX": 1,
        "startY": 1,
        "tile": 0
    },
    "treasure":
    [
        {
            "startX": 4,
            "startY": 1,
            "tile": 2,
            "points": 100
        }
    ],
    "monster":
    [
        {
            "startX": 11,
            "startY": 4,
            "tile": 5,
            "damage": 10,
            "type": "SN"
        },
        {
            "startX": 5,
            "startY": 5,
            "tile": 5,
            "damage": 10,
            "type": "RND"
        }
    ],
    "exit":
    [
        {
            "startX": 14,
            "startY": 13,
            "tile": 4,
            "destination": "level01"
        }
    ]
}